##################################################################################################################################################
#...........................#...........#...........#...........#................#...............................................................#
#...................#..####..######.######..########..#########..#####........#####........############...........###########....................#
#...................#............................................................................................................................#
#...................############.............#.................#.............####.............................################...................#
#...................#..........###############........................................................##########................##################
#...................#............................................................................................................................#
#...................######################.......................############...........................#########..............###################
##################################################################################################################################################
