####################################################################################################
#..................................................................................................#
#...........................#####.#####..............#####.........................................#
#...##########.............#.........#..............#............................#####.............#
#...........#...............#.........#...........#####.........#####...........#..................#
#...........#####...........############..............#.........................#..................#
#................#.....................................#.............#############.................#
#................#.....#####...................########............................................#
#................#...................................................###############################
####################################################################################################
