###############################################################################
#................................###########..................................#
#.................................#........#..................................#
#....#############...............#####......#.................................#
#................#.........................#####..............................#
#...#########....#.......##############...........#############################
#...............#........#.............#.................#....................#
#...............#........#.............##################.....................#
#...............###########....................................#########......#
#.............................................########........................#
###############################################################################
