##################################################################################################################################################
#...............................................###############..........#############...........................................................#
#...............................................#..............#.......#..............#..........................................................#
#........########...................########....#..............#########..............########...................########...............######...#
#........#......#........##########...........................................#########......#........##########......#########...........######.#
#........#...............#.....................###########################.....................#########......................#...........######.#
#........########........###############################################.......................................................#############.....#
##################################################################################################################################################
