########################################################################################################################################
#....................###############....................................................###############................................#
#.........................................................................###########..................................................#
#.....#########.............#####................#####.............#####.............#####..............#######......................###
#...............#######.........................#####.............#####......................#######...................................#
#.......................###################.....#####.............#####.....########################...................................#
#..............................................#####.............#####.................................................................#
#................................#########.....#####.............#####.....#####.......................................................#
#..............................................#####.............#####.................................................................#
########################################################################################################################################
