####################################################################################################
#..............#####...........#####.................................#####...........#####.........#
#..........###.....###.....###.....###...........................###.....###.....###.....###.......#
#.............###########.....#########.............................###########.....#########......#
#..................................................................................................#
#....#########################################....................##################################
#..................................................................................................#
#..........................................................................##########..............#
#..................................................................................................#
#..................................................................................................#
####################################################################################################
