##################################################
#.............................#..................#
#...................#####.....#..................#
#.......................#.....#..................#
#...#########..........#.....#############.......#
#...........#..........#.........................#
#...........#..........########..................#
#...........#....................................#
#...........######################################
##################################################
