########################################################################################################################################
#......................................................................................................................................#
#.######################.................######################.............########################.......................#############
#..........................#######............................................................#######.....................#............#
#......................#############....................................................#############.....................############.#
#...###############################.......................##########................######################.............................#
#.................................................................................................................######################
########################################################################################################################################
