##################################################################################################################################################
#..............................#######################................#######################....................................................#
#..............................#.....................#................#.....................#....................................................#
#..............................#.....................###############..#.....................###############......................................#
#......############............###############........................###############.................########.............####.###..............#
#......#..........#...............................................................#.........................................#.....#..............#
#......######.########.............###############................###############################........###############.....#####...............#
#................................................................................................................................................#
#................................................................................................................................................#
##################################################################################################################################################
