########################################################################################################################################
#...............############.............................................................................############..................#
#.........................#####...................................................#####................................................#
#.....................##########................................................##########................#####........................#
#.....................#........########...............................###########........#.............................................#
#.......###########......................................................................#...###########...............................#
#.......#..............###############..............................###############.......#############................................#
#.......#............................#####......................#####....................#####.........................................#
#.......###############...............###########.........###############...............###########........##########..................#
########################################################################################################################################
