#....########
####..####.V#
#.###.####..#
#...........#
#############